0000000000000
0101010101010
0101010101010
0101011101010
0101000001010
0000010100000
1011000001101
0000011100000
0101010101010
0101010101010
0101000001010
0000203000000